GCA	Ala	A
GCC	Ala	A
GCG	Ala	A
GCT	Ala	A
TGC	Cys	C
TGT	Cys	C
GAC	Asp	D
GAT	Asp	D
GAA	Glu	E
GAG	Glu	E
TTC	Phe	F
TTT	Phe	F
GGA	Gly	G
GGC	Gly	G
GGG	Gly	G
GGT	Gly	G
CAC	His	H
CAT	His	H
ATA	Ile	I
ATC	Ile	I
ATT	Ile	I
AAA	Lys	K
AAG	Lys	K
CTA	Leu	L
CTC	Leu	L
CTG	Leu	L
CTT	Leu	L
TTA	Leu	L
TTG	Leu	L
ATG	Met	M
AAC	Asn	N
AAT	Asn	N
CCA	Pro	P
CCC	Pro	P
CCG	Pro	P
CCT	Pro	P
CAA	Gln	Q
CAG	Gln	Q
AGA	Arg	R
AGG	Arg	R
CGA	Arg	R
CGC	Arg	R
CGG	Arg	R
CGT	Arg	R
AGC	Ser	S
AGT	Ser	S
TCA	Ser	S
TCC	Ser	S
TCG	Ser	S
TCT	Ser	S
ACA	Thr	T
ACC	Thr	T
ACG	Thr	T
ACT	Thr	T
GTA	Val	V
GTC	Val	V
GTG	Val	V
GTT	Val	V
TGG	Trp	W
TAC	Tyr	Y
TAT	Tyr	Y
TAA	stop	*
TAG	stop	*
TGA	stop	*
